#######################
#.         #          #
# ### #### # #### ### #
#o### #### # #### ###o#
#                     #
# ### # ####### # ### #
#     #    #    #     #
##### #### # #### #####
#   # #    =    # #   #
##### # ### ### # #####
#       # === #       #
##### # ####### # #####
#   # #    %    # #   #
##### # ####### # #####
#          #          #
# ### #### # #### ### #
#o  #      \      #  o#
### # # ####### # # ###
#     #    #    #     #
# ######## # ######## #
#                     #
#######################
